word	type
blaring	descriptor
dry	descriptor
chippy	descriptor
swirl	descriptor
pattering	descriptor
stinger	descriptor
chime	descriptor
jar	descriptor
thin	descriptor
harmonic	descriptor
weather	descriptor
breath	descriptor
rocky	descriptor
phone	descriptor
female	descriptor
coarse	descriptor
transitional	descriptor
stifled	descriptor
filmic	descriptor
distorted	descriptor
broken	descriptor
sustained	descriptor
baritone	descriptor
hateful	descriptor
abrasive	descriptor
squeaky	descriptor
police	descriptor
surprise	descriptor
ominous	descriptor
sizzling	descriptor
desperate	descriptor
cold	descriptor
spatial	descriptor
clicky	descriptor
collecting	descriptor
smooth	descriptor
zippy	descriptor
short	descriptor
warm	descriptor
mechanistic	descriptor
whiny	descriptor
alarming	descriptor
soothing	descriptor
calculated	descriptor
blunt	descriptor
creepy	descriptor
crying	descriptor
tinkling	descriptor
scraping	descriptor
movement	descriptor
kind	descriptor
environmental	descriptor
tetra	descriptor
continuous	descriptor
ambience	descriptor
machine	descriptor
balanced	descriptor
fluctuation	descriptor
thunderous	descriptor
wavering	descriptor
crinkly	descriptor
sweep	descriptor
expectant	descriptor
bubbly	descriptor
drone	descriptor
watery	descriptor
energetic	descriptor
reverberant	descriptor
percussive	descriptor
spray	descriptor
scratch	descriptor
edgy	descriptor
instrument	descriptor
thudding	descriptor
motorized	descriptor
impact	descriptor
shrill	descriptor
brassy	descriptor
evolving	descriptor
crunchy	descriptor
harsh	descriptor
harmonious	descriptor
phasing	descriptor
descending	descriptor
obnoxious	descriptor
conversational	descriptor
uplifting	descriptor
silky	descriptor
swish	descriptor
gurgly	descriptor
jarring	descriptor
ending	descriptor
brittle	descriptor
scanning	descriptor
scary	descriptor
swirly	descriptor
persistent	descriptor
serene	descriptor
punctual	descriptor
muted	descriptor
whiney	descriptor
frenzied	descriptor
stepping	descriptor
dangerous	descriptor
playful	descriptor
wheezy	descriptor
reverb	descriptor
tiny	descriptor
alien	descriptor
phased	descriptor
grainy	descriptor
sparking	descriptor
layered	descriptor
roomy	descriptor
arctic	descriptor
manly	descriptor
unsteady	descriptor
applause	descriptor
rumbling	descriptor
filtered	descriptor
childlike	descriptor
awful	descriptor
ugly	descriptor
bubbling	descriptor
unzipping	descriptor
young	descriptor
pitchy	descriptor
metal	descriptor
tonal	descriptor
ticking	descriptor
raspy	descriptor
wild	descriptor
fast	descriptor
strident	descriptor
urgent	descriptor
paranormal	descriptor
sensory	descriptor
airy	descriptor
distant	descriptor
anthro	descriptor
dark	descriptor
tinny	descriptor
fragmented	descriptor
boisterous	descriptor
chaotic	descriptor
dying	descriptor
forceful	descriptor
notification	descriptor
announcing	descriptor
raw	descriptor
intimate	descriptor
interstellar	descriptor
lively	descriptor
jerk	descriptor
rythm	descriptor
siren	descriptor
calming	descriptor
textile	descriptor
soft	descriptor
musical	descriptor
electric	descriptor
sharp	descriptor
close	descriptor
mechanical	descriptor
rain	descriptor
gut	descriptor
hollow	descriptor
loud	descriptor
tripping	descriptor
swinging	descriptor
ambulance	descriptor
organic	descriptor
opening	descriptor
twinkling	descriptor
aggressive	descriptor
spike	descriptor
cycle	descriptor
safe	descriptor
incongruent	descriptor
digital	descriptor
damaged	descriptor
whispered	descriptor
robust	descriptor
rubbery	descriptor
scratchy	descriptor
shallow	descriptor
reversed	descriptor
splashy	descriptor
ring	descriptor
noisy	descriptor
snap	descriptor
sweetener	descriptor
thunder	descriptor
stuttering	descriptor
buzzing	descriptor
skittering	descriptor
resonant	descriptor
strong	descriptor
quick	descriptor
compressed	descriptor
expansive	descriptor
transient	descriptor
chirpy	descriptor
busy	descriptor
joyous	descriptor
boing	descriptor
aspirational	descriptor
warning	descriptor
whispery	descriptor
instinctual	descriptor
wailing	descriptor
vocal	descriptor
lovely	descriptor
pulsating	descriptor
loop	descriptor
manufactured	descriptor
droning	descriptor
suspended	descriptor
electronic	descriptor
concluding	descriptor
naturalistic	descriptor
nasal	descriptor
haunting	descriptor
magnetic	descriptor
crisp	descriptor
sloshy	descriptor
round	descriptor
subtle	descriptor
eerie	descriptor
rough	descriptor
enticing	descriptor
skillful	descriptor
grinding	descriptor
purr	descriptor
synthetic	descriptor
massive	descriptor
debris	descriptor
consistent	descriptor
dour	descriptor
wooshing	descriptor
collision	descriptor
vexatious	descriptor
bounce	descriptor
cutting	descriptor
chimney	descriptor
inclusive	descriptor
bouncy	descriptor
orderly	descriptor
assaulting	descriptor
fuzzy	descriptor
voices	descriptor
hard	descriptor
crowd	descriptor
feedback	descriptor
echoing	descriptor
sports	descriptor
human	descriptor
pure	descriptor
earthy	descriptor
gutteral	descriptor
bright	descriptor
interior	descriptor
crashing	descriptor
futuristic	descriptor
frenetic	descriptor
small	descriptor
deep	descriptor
empty	descriptor
moist	descriptor
muffled	descriptor
slow	descriptor
harmless	descriptor
bracing	descriptor
quiet	descriptor
informative	descriptor
ghostly	descriptor
scuffling	descriptor
zipping	descriptor
enclosed	descriptor
alert	descriptor
piercing	descriptor
nature	descriptor
boomy	descriptor
natural	descriptor
granular	descriptor
light	descriptor
powerful	descriptor
grating	descriptor
melodic	descriptor
whoosh	descriptor
doppler	descriptor
rhythmic	descriptor
rustle	descriptor
insect	descriptor
approaching	descriptor
robotic	descriptor
destructive	descriptor
thundering	descriptor
squirt	descriptor
alarm	descriptor
intrusive	descriptor
relentless	descriptor
cute	descriptor
mellow	descriptor
beating	descriptor
buzzy	descriptor
exciting	descriptor
dialog	descriptor
hit	descriptor
scrape	descriptor
repetitive	descriptor
piggy	descriptor
sublime	descriptor
orchestral	descriptor
metallic	descriptor
reedy	descriptor
wet	descriptor
kerplunk	descriptor
rubbing	descriptor
plosive	descriptor
windy	descriptor
annoying	descriptor
screechy	descriptor
retro	descriptor
popping	descriptor
echoey	descriptor
comfortable	descriptor
midrange	descriptor
whistle	descriptor
happy	descriptor
toy	descriptor
droney	descriptor
artificial	descriptor
falling	descriptor
stormy	descriptor
urgency	descriptor
muddy	descriptor
dissonant	descriptor
frying	descriptor
stretching	descriptor
rounded	descriptor
crashy	descriptor
cacophonic	descriptor
breathy	descriptor
liquid	descriptor
pouting	descriptor
monotonous	descriptor
glottal	descriptor
thick	descriptor
surprised	descriptor
construction	descriptor
angry	descriptor
flick	descriptor
crinkle	descriptor
dynamic	descriptor
regal	emotion
satisfying	emotion
blaring	emotion
melancholy	emotion
blank	emotion
questioning	emotion
amusing	emotion
impending	emotion
humourous	emotion
irksome	emotion
excited	emotion
exploratory	emotion
implacability	emotion
alleviating	emotion
oppressive	emotion
positive	emotion
probing	emotion
abrasive	emotion
strange	emotion
ominous	emotion
enervating	emotion
unnerving	emotion
comfort	emotion
acute	emotion
smooth	emotion
warm	emotion
humorous	emotion
painful	emotion
alarming	emotion
sad	emotion
alerted	emotion
dropping	emotion
distressing	emotion
welcoming	emotion
frustrating	emotion
speed	emotion
surprising	emotion
annoyed	emotion
spooky	emotion
scare	emotion
anguish	emotion
movement	emotion
fearful	emotion
peace	emotion
jangling	emotion
chromatic	emotion
timid	emotion
expectant	emotion
stressful	emotion
concerning	emotion
unwelcome	emotion
agitated	emotion
indifferent	emotion
watery	emotion
energetic	emotion
furious	emotion
anticipation	emotion
spinning	emotion
alerting	emotion
crackle	emotion
edgy	emotion
fear	emotion
nervous	emotion
overwhelmed	emotion
itchy	emotion
high	emotion
shrill	emotion
hectic	emotion
bored	emotion
harmonious	emotion
funny	emotion
conversational	emotion
uplifting	emotion
clumsy	emotion
intriguing	emotion
tension	emotion
mystified	emotion
jarring	emotion
otherworldly	emotion
touching	emotion
scary	emotion
textural	emotion
amused	emotion
smoothed	emotion
worried	emotion
neurotic	emotion
emergency	emotion
dangerous	emotion
playful	emotion
unknown	emotion
radar	emotion
peaceful	emotion
disturbing	emotion
depth	emotion
chill	emotion
curious	emotion
grainy	emotion
intense	emotion
rushed	emotion
negative	emotion
relieved	emotion
awful	emotion
suspenseful	emotion
terrifying	emotion
unconscious	emotion
proximate	emotion
anticipatory	emotion
ripping	emotion
jelly	emotion
delighted	emotion
fast	emotion
displeased	emotion
strident	emotion
upset	emotion
agitating	emotion
urgent	emotion
relaxing	emotion
pleasent	emotion
esoteric	emotion
mystic	emotion
joyful	emotion
awe	emotion
dark	emotion
spontaneous	emotion
chaotic	emotion
torrential	emotion
purposeful	emotion
courtly	emotion
texture	emotion
focused	emotion
shock	emotion
reassuring	emotion
antiseptic	emotion
calming	emotion
ardent	emotion
soft	emotion
sharp	emotion
close	emotion
whisper	emotion
carefree	emotion
hungry	emotion
alive	emotion
mechanical	emotion
comedic	emotion
approach	emotion
assertive	emotion
warmth	emotion
tense	emotion
hollow	emotion
anxious	emotion
loud	emotion
strength	emotion
dignified	emotion
hopeful	emotion
nerdy	emotion
oops	emotion
nostalgic	emotion
motion	emotion
amazonian	emotion
elastic	emotion
settling	emotion
confusing	emotion
overwhelming	emotion
noisy	emotion
unsettling	emotion
cringe	emotion
energizing	emotion
quick	emotion
relaxed	emotion
proud	emotion
cartoonish	emotion
busy	emotion
warning	emotion
deliberate	emotion
homey	emotion
brutal	emotion
unpleasant	emotion
encouraging	emotion
cautious	emotion
cheerful	emotion
gravity	emotion
profound	emotion
claustrophobic	emotion
naturalistic	emotion
moody	emotion
saccharine	emotion
walking	emotion
jaunty	emotion
enticing	emotion
defensive	emotion
trudging	emotion
twinkly	emotion
clunky	emotion
impactful	emotion
release	emotion
romantic	emotion
desolate	emotion
refreshing	emotion
impatient	emotion
silly	emotion
upbeat	emotion
intrigued	emotion
confused	emotion
sorrow	emotion
majestic	emotion
stimulating	emotion
sand	emotion
escape	emotion
comforting	emotion
comical	emotion
dizzy	emotion
travel	emotion
irritating	emotion
hot	emotion
startled	emotion
mysterious	emotion
inquisitive	emotion
neutral	emotion
gross	emotion
animal	emotion
pause	emotion
bright	emotion
futuristic	emotion
freeing	emotion
explosive	emotion
empty	emotion
pleasant	emotion
moist	emotion
brash	emotion
unidentifiable	emotion
rush	emotion
abrupt	emotion
finality	emotion
alert	emotion
intimacy	emotion
nature	emotion
action	emotion
natural	emotion
light	emotion
calm	emotion
sudden	emotion
powerful	emotion
sexy	emotion
reliable	emotion
alarmed	emotion
swift	emotion
tranquil	emotion
papery	emotion
rhythmic	emotion
accidental	emotion
synthesized	emotion
undulate	emotion
breezy	emotion
panicked	emotion
alarm	emotion
panic	emotion
growing	emotion
wonderment	emotion
mellow	emotion
stressed	emotion
awkward	emotion
boring	emotion
loose	emotion
open	emotion
exciting	emotion
foreign	emotion
industrious	emotion
gentle	emotion
tight	emotion
determined	emotion
suspense	emotion
pain	emotion
uncomfortable	emotion
annoying	emotion
steadiness	emotion
antagonistic	emotion
comfortable	emotion
happy	emotion
artificial	emotion
immersed	emotion
falling	emotion
urgency	emotion
mulled	emotion
uneasy	emotion
tone	emotion
affection	emotion
flutter	emotion
focussed	emotion
emotional	emotion
horrific	emotion
fuzz	emotion
inspired	emotion
surprised	emotion
danger	emotion
angry	emotion
dynamic	emotion
