word	type
relentless	descriptor
inclusive	descriptor
solid	descriptor
sophisticated	descriptor
hollow	descriptor
suspended	descriptor
masterful	descriptor
gutteral	descriptor
crunchy	descriptor
grinding	descriptor
complex	descriptor
slow	descriptor
sonic	descriptor
expectant	descriptor
rain	descriptor
seductive	descriptor
rowdy	descriptor
reedy	descriptor
crinkly	descriptor
beating	descriptor
jerk	descriptor
rubbing	descriptor
tight	descriptor
latest	descriptor
crashing	descriptor
spatial	descriptor
wailing	descriptor
reversed	descriptor
thunderous	descriptor
splashy	descriptor
thick	descriptor
small	descriptor
classic	descriptor
bassy	descriptor
dialog	descriptor
surprising	descriptor
distinct	descriptor
hushed	descriptor
textured	descriptor
collecting	descriptor
tender	descriptor
humming	descriptor
angry	descriptor
melodic	descriptor
busy	descriptor
funky	descriptor
whistling	descriptor
sweep	descriptor
resounding	descriptor
consistent	descriptor
wheezy	descriptor
enticing	descriptor
gentle	descriptor
announcing	descriptor
dry	descriptor
pure	descriptor
edgy	descriptor
ring	descriptor
roomy	descriptor
shallow	descriptor
ethereal	descriptor
concluding	descriptor
thudding	descriptor
descending	descriptor
muffled	descriptor
close	descriptor
resonant	descriptor
transporting	descriptor
haunting	descriptor
boisterous	descriptor
unsteady	descriptor
tinny	descriptor
sprawling	descriptor
dissonant	descriptor
short	descriptor
tetra	descriptor
alien	descriptor
notable	descriptor
visionary	descriptor
accessible	descriptor
toy	descriptor
dour	descriptor
coarse	descriptor
squirt	descriptor
manufactured	descriptor
round	descriptor
grainy	descriptor
swish	descriptor
thunder	descriptor
baritone	descriptor
sustained	descriptor
breathtaking	descriptor
female	descriptor
throbbing	descriptor
glottal	descriptor
discordant	descriptor
refined	descriptor
electronic	descriptor
phased	descriptor
gurgly	descriptor
modulated	descriptor
filmic	descriptor
calculated	descriptor
alarm	descriptor
watery	descriptor
raucous	descriptor
danceable	descriptor
muted	descriptor
effortless	descriptor
successful	descriptor
liquid	descriptor
unexpected	descriptor
popping	descriptor
siren	descriptor
cutting	descriptor
abrasive	descriptor
timeless	descriptor
buzzy	descriptor
gurgling	descriptor
broken	descriptor
piercing	descriptor
open	descriptor
nature	descriptor
vocal	descriptor
poetic	descriptor
sensitive	descriptor
natural	descriptor
conceptual	descriptor
innocent	descriptor
eclectic	descriptor
artificial	descriptor
scuffling	descriptor
brittle	descriptor
human	descriptor
thin	descriptor
happy	descriptor
cacophonic	descriptor
ghostly	descriptor
approaching	descriptor
evolving	descriptor
eerie	descriptor
lyrical	descriptor
piggy	descriptor
intoxicating	descriptor
striking	descriptor
instrument	descriptor
transitional	descriptor
calming	descriptor
fragmented	descriptor
refrain	descriptor
uproarious	descriptor
reverb	descriptor
sensory	descriptor
polished	descriptor
persistent	descriptor
enclosed	descriptor
motorized	descriptor
raw	descriptor
groaning	descriptor
impacting	descriptor
mythical	descriptor
crisp	descriptor
whirring	descriptor
delightful	descriptor
sweet	descriptor
bouncy	descriptor
dull	descriptor
full	descriptor
sparking	descriptor
whispery	descriptor
rattling	descriptor
conversational	descriptor
dying	descriptor
paranormal	descriptor
doppler	descriptor
transient	descriptor
clicky	descriptor
strong	descriptor
stinger	descriptor
ticking	descriptor
whispered	descriptor
tinkling	descriptor
insect	descriptor
swooshing	descriptor
echoey	descriptor
wet	descriptor
soft	descriptor
phasing	descriptor
riveting	descriptor
chirpy	descriptor
strident	descriptor
arctic	descriptor
movement	descriptor
muddy	descriptor
damaged	descriptor
rough	descriptor
kind	descriptor
brilliant	descriptor
nasal	descriptor
wild	descriptor
layered	descriptor
noisy	descriptor
distant	descriptor
desperate	descriptor
sombre	descriptor
unpredictable	descriptor
skillful	descriptor
harsh	descriptor
comfortable	descriptor
stepping	descriptor
scrape	descriptor
enigmatic	descriptor
collision	descriptor
spike	descriptor
impact	descriptor
stunning	descriptor
whoosh	descriptor
pulsating	descriptor
echoing	descriptor
urgent	descriptor
crying	descriptor
squeaky	descriptor
epic	descriptor
stratospheric	descriptor
pulsing	descriptor
lively	descriptor
energetic	descriptor
breath	descriptor
aspirational	descriptor
screechy	descriptor
listenable	descriptor
studied	descriptor
fast	descriptor
empty	descriptor
clever	descriptor
environmental	descriptor
metal	descriptor
textile	descriptor
fresh	descriptor
primal	descriptor
booming	descriptor
crashy	descriptor
mellow	descriptor
weather	descriptor
emit	descriptor
droney	descriptor
anthro	descriptor
sharp	descriptor
pouting	descriptor
stifled	descriptor
clean	descriptor
transcendent	descriptor
digital	descriptor
squeaking	descriptor
pounding	descriptor
frenzied	descriptor
tiny	descriptor
mesmerizing	descriptor
audible	descriptor
purring	descriptor
ringing	descriptor
grating	descriptor
thundering	descriptor
powerful	descriptor
uneven	descriptor
inviting	descriptor
rustle	descriptor
unique	descriptor
damped	descriptor
metallic	descriptor
kerplunk	descriptor
rubbery	descriptor
police	descriptor
organic	descriptor
crowd	descriptor
machine	descriptor
cute	descriptor
blunt	descriptor
instrumental	descriptor
talented	descriptor
exceptional	descriptor
rounded	descriptor
young	descriptor
distorted	descriptor
quiet	descriptor
groundbreaking	descriptor
reverbed	descriptor
scratchy	descriptor
passionate	descriptor
gushing	descriptor
orderly	descriptor
warning	descriptor
grandiose	descriptor
whiney	descriptor
repetitive	descriptor
scanning	descriptor
moist	descriptor
trailblazing	descriptor
staccato	descriptor
childlike	descriptor
plosive	descriptor
melodious	descriptor
fuzzy	descriptor
sublime	descriptor
pattering	descriptor
compressed	descriptor
almighty	descriptor
rapping	descriptor
skilled	descriptor
intrusive	descriptor
punctual	descriptor
rumbling	descriptor
reverberant	descriptor
shrill	descriptor
safe	descriptor
saturated	descriptor
intimate	descriptor
perfect	descriptor
dynamic	descriptor
annoying	descriptor
trademark	descriptor
construction	descriptor
exhilarating	descriptor
cycle	descriptor
aggressive	descriptor
vibratory	descriptor
pitchy	descriptor
alert	descriptor
debris	descriptor
breathy	descriptor
pinging	descriptor
urgency	descriptor
synthetic	descriptor
focused	descriptor
bold	descriptor
scraping	descriptor
plaintive	descriptor
deafening	descriptor
sports	descriptor
flick	descriptor
heartfelt	descriptor
electric	descriptor
poignant	descriptor
cohesive	descriptor
inventive	descriptor
alarming	descriptor
cold	descriptor
moody	descriptor
wavering	descriptor
midrange	descriptor
frying	descriptor
chaotic	descriptor
roaring	descriptor
obnoxious	descriptor
serene	descriptor
spray	descriptor
hypnotic	descriptor
limitless	descriptor
upbeat	descriptor
harmonic	descriptor
unsung	descriptor
satisfying	descriptor
naturalistic	descriptor
whistle	descriptor
vexatious	descriptor
retro	descriptor
tripping	descriptor
zippy	descriptor
sweetener	descriptor
bubbly	descriptor
catchy	descriptor
granular	descriptor
midtempo	descriptor
riotous	descriptor
stormy	descriptor
musical	descriptor
falling	descriptor
invigorating	descriptor
stuttering	descriptor
surprise	descriptor
soaring	descriptor
dulcet	descriptor
jangling	descriptor
filtered	descriptor
clanking	descriptor
introspective	descriptor
interior	descriptor
applause	descriptor
balanced	descriptor
instinctual	descriptor
light	descriptor
symphonic	descriptor
sonorous	descriptor
swinging	descriptor
buzzing	descriptor
ambience	descriptor
phone	descriptor
playful	descriptor
mechanistic	descriptor
harmless	descriptor
drone	descriptor
bubbling	descriptor
windy	descriptor
indulgent	descriptor
notification	descriptor
fluid	descriptor
uplifting	descriptor
airy	descriptor
robotic	descriptor
harmonious	descriptor
tumultuous	descriptor
rhythmic	descriptor
sizzling	descriptor
hard	descriptor
flawless	descriptor
chimney	descriptor
blissful	descriptor
frenetic	descriptor
loop	descriptor
sloshy	descriptor
even	descriptor
percussive	descriptor
chime	descriptor
robust	descriptor
soothing	descriptor
boomy	descriptor
whiny	descriptor
definitive	descriptor
twinkling	descriptor
exciting	descriptor
unzipping	descriptor
warm	descriptor
lilting	descriptor
knocking	descriptor
assaulting	descriptor
expansive	descriptor
brassy	descriptor
joyous	descriptor
beautiful	descriptor
creepy	descriptor
rythm	descriptor
swirly	descriptor
howling	descriptor
hit	descriptor
skittering	descriptor
blaring	descriptor
thrilling	descriptor
bright	descriptor
insistent	descriptor
continuous	descriptor
monotonous	descriptor
hissing	descriptor
futuristic	descriptor
tonal	descriptor
raspy	descriptor
clear	descriptor
swirl	descriptor
informative	descriptor
voices	descriptor
inaudible	descriptor
droning	descriptor
ambulance	descriptor
feedback	descriptor
zipping	descriptor
mechanical	descriptor
stylistic	descriptor
dangerous	descriptor
explosive	descriptor
dark	descriptor
stylish	descriptor
rich	descriptor
dripping	descriptor
headbanging	descriptor
ending	descriptor
deep	descriptor
subtle	descriptor
bounce	descriptor
magnetic	descriptor
massive	descriptor
fluctuation	descriptor
cerebral	descriptor
scary	descriptor
rollicking	descriptor
loud	descriptor
flat	descriptor
rocky	descriptor
earthy	descriptor
silky	descriptor
smooth	descriptor
lush	descriptor
action	emotion
open	emotion
nature	emotion
calm	emotion
spontaneous	emotion
claustrophobic	emotion
amazonian	emotion
implacability	emotion
tone	emotion
cautious	emotion
focussed	emotion
nerdy	emotion
alive	emotion
peace	emotion
relieved	emotion
funny	emotion
satisfying	emotion
tranquil	emotion
naturalistic	emotion
smoothed	emotion
agitating	emotion
natural	emotion
danger	emotion
irksome	emotion
painful	emotion
artificial	emotion
accidental	emotion
expectant	emotion
nostalgic	emotion
desolate	emotion
alerted	emotion
abrupt	emotion
powerful	emotion
antagonistic	emotion
hectic	emotion
encouraging	emotion
refreshing	emotion
happy	emotion
defensive	emotion
amused	emotion
touching	emotion
torrential	emotion
falling	emotion
upset	emotion
negative	emotion
trudging	emotion
alerting	emotion
spinning	emotion
irritating	emotion
tight	emotion
pleasent	emotion
timid	emotion
mystified	emotion
sexy	emotion
freeing	emotion
strength	emotion
deliberate	emotion
emergency	emotion
jangling	emotion
calming	emotion
saccharine	emotion
uneasy	emotion
bored	emotion
fearful	emotion
neutral	emotion
twinkly	emotion
stressed	emotion
comedic	emotion
romantic	emotion
alarmed	emotion
intimacy	emotion
light	emotion
stimulating	emotion
travel	emotion
welcoming	emotion
mysterious	emotion
distressing	emotion
surprised	emotion
suspense	emotion
swift	emotion
impatient	emotion
playful	emotion
nervous	emotion
surprising	emotion
impactful	emotion
panic	emotion
anticipatory	emotion
anticipation	emotion
terrifying	emotion
excited	emotion
angry	emotion
emotional	emotion
busy	emotion
release	emotion
unsettling	emotion
rushed	emotion
boring	emotion
gross	emotion
unpleasant	emotion
jaunty	emotion
approach	emotion
uplifting	emotion
peaceful	emotion
inquisitive	emotion
warning	emotion
indifferent	emotion
comfort	emotion
harmonious	emotion
sad	emotion
clumsy	emotion
rhythmic	emotion
affection	emotion
antiseptic	emotion
enticing	emotion
enervating	emotion
intriguing	emotion
moist	emotion
gentle	emotion
impending	emotion
jarring	emotion
joyful	emotion
otherworldly	emotion
neurotic	emotion
soft	emotion
steadiness	emotion
anguish	emotion
reliable	emotion
strident	emotion
mystic	emotion
cringe	emotion
probing	emotion
movement	emotion
oppressive	emotion
exciting	emotion
rush	emotion
questioning	emotion
disturbing	emotion
breezy	emotion
ominous	emotion
edgy	emotion
warm	emotion
scare	emotion
annoyed	emotion
overwhelmed	emotion
esoteric	emotion
noisy	emotion
proximate	emotion
cheerful	emotion
dignified	emotion
determined	emotion
delighted	emotion
relaxed	emotion
sudden	emotion
comical	emotion
close	emotion
reassuring	emotion
comfortable	emotion
relaxing	emotion
overwhelming	emotion
whisper	emotion
walking	emotion
blaring	emotion
worried	emotion
panicked	emotion
warmth	emotion
dynamic	emotion
purposeful	emotion
annoying	emotion
carefree	emotion
bright	emotion
comforting	emotion
urgent	emotion
anxious	emotion
dropping	emotion
tense	emotion
itchy	emotion
futuristic	emotion
growing	emotion
ardent	emotion
confused	emotion
unidentifiable	emotion
depth	emotion
frustrating	emotion
suspenseful	emotion
animal	emotion
concerning	emotion
unconscious	emotion
intense	emotion
pleasant	emotion
spooky	emotion
alert	emotion
pain	emotion
energizing	emotion
regal	emotion
agitated	emotion
amusing	emotion
energetic	emotion
blank	emotion
majestic	emotion
mechanical	emotion
humourous	emotion
curious	emotion
awkward	emotion
assertive	emotion
courtly	emotion
loose	emotion
dangerous	emotion
explosive	emotion
urgency	emotion
immersed	emotion
pause	emotion
hungry	emotion
clunky	emotion
fast	emotion
focused	emotion
dark	emotion
displeased	emotion
startled	emotion
hot	emotion
homey	emotion
humorous	emotion
synthesized	emotion
fear	emotion
motion	emotion
confusing	emotion
alleviating	emotion
alarm	emotion
watery	emotion
unnerving	emotion
uncomfortable	emotion
settling	emotion
alarming	emotion
mulled	emotion
mellow	emotion
moody	emotion
profound	emotion
industrious	emotion
foreign	emotion
speed	emotion
scary	emotion
abrasive	emotion
shock	emotion
radar	emotion
loud	emotion
chaotic	emotion
exploratory	emotion
strange	emotion
unknown	emotion
smooth	emotion
cartoonish	emotion
